#########################
#$####      %#######   @#
# #    ##     &#   # ## #
# # ##### ###### # # ## #
# #   # #        # # ## #
# # # ###### # # #   ## #
# #          # # ####   #
# # ######## # #       ##
# #  ###     ### ###   ##
# ## ##  ### #     ###  #
# #  #  ##  #######   &##
# # ## ##            ####
# #  ##&#################
# # ##                ###
# #    #### #######   ###
# #####            ## ###
# ##       ##### #### ###
# #### #####      ##  ###
# ####  ##            ###
# #    ## #  ### ####   #
# # # #   # ### ##### # #
# # #   ### #   ##    # #
# ########  # #     ### #
#&                ####& #
#########################