###############
##&           #
##    ###   # #
## ## #     # #
## ##  #    # #
## #    ##  #&#
## #        #$#
##   ## ##  ###
## # #   ##  ##
#%##         ##
#  ##      ####
## ##    ##  ##
#&    ##  #  ##
# #    #     @#
###############