####################
#&     ##&     ### #
## ##   ####    ## #
##  # #     ###    #
### ####   ####### #
### ####      ###  #
#      #       ### #
# ###### # ####### #
# ###### # ####### #
#  #    @    #   # #
## #### ## # #  &  #
## #### ## #   #####
## #    ## #########
## # ##### ###    ##
#  #    %#    ### ##
# ##### ## ###### ##
# ###  ###        ##
# ##  ###### #######
#$   #            &#
####################